##     B
## #####
## #####
## #####
## #####
## #####
A  #####